#########
#.......#
#.o..#x##
#.#.oZ..#
#..@..x.#
#########
