#############
#.......#..x#
#.o..#x##..##
#.#.o~..o...#
#..@.~x.##.##
#..#.~......#
#############
