#########
#...~...#
#.o..#x##
#.#.o...#
#..@..x.#
#########
